D                       C
D  HGF GF  GF  GF  GF   C
D                       C
D                       C
D                       C
D                       C
D                       C
D   &   <   *   ?   +   C
D  EEE EEE EEE EEE EEE  C
D                       C
BBBBBBBBBBBBBBBBBBBBBBBBB